################
#   X  @ GGGGGG#
#        GGGGGG#
#              #
#              #
#      d       #
#  d       d   #
# d         d  #
#d     C     d #
# d         d  #
#  d       d   #
#      d       #
#              #
#              #
#              #
################
